SO ./textures/bayrak.xpm
EA ./textures/harita.xpm
NO ./textures/kusatma.xpm
WE ./textures/metehan.xpm

F 0,225,255
C 2,255,100


      11111111111111111
111111110000000000000011
11111111111111111111111
10101000001         101
100000000001    111111
1000000001011111111111
100001110001   1000001
100W00000001   100001
100000000000111111111
1111111111101
          11111111111111111111111111111
11111111111011111111111111111110111111
100000000000000111111111111111111111111111
1111111111111111111111
1111111111111
111
