SO ./textures/turan.xpm
EA ./textures/atilla.xpm
NO ./textures/fatih.xpm
WE ./textures/metehan.xpm

C 50,50,50
F 30,30,30

      11111111111111111
111111110000000000000011
11111111111111111111111
10101000001         101
100000000001    111111
100000W001011111111111
100001110001   1000001
100000000011   100001
100000000000111111111
1111111111101
          11111111111111111111111111111
11111111111011111111111111111110111111
100000000000000111111111111111111111111111
1111111111111111111111
1111111111111
111