SO ./textures/bayrak.xpm
EA ./textures/harita.xpm
NO ./textures/kusatma.xpm
WE ./textures/metehan.xpm

C 2,255,100
F 0,225,255

1111111111111
1011111011111111
11111111       1
111111111111111
11N11111111
100000011111
111111111111
